#####A#
####  #
#### ##
#### ##
##B  ##